VVVBVVZVVV
VPPPRPPPPV
VPVVVVCBPV
VVVVVVVVPV
VPZBPPVPPV
VPVVPVVVVV
VPPPPVZVVZ
VVCVVVVVVV
VVVVZVVVPV
VBVVVVRVPG