VVPPVBPPVV
VVPPZVPPVV
VVPVRVVZVV
VBPVVVVVVR
VVVVPPPVVV
VVZVVVPVVZ
VVVVPBPVVV
VVVVPPPVVV
VVVCVZVVVV
VVBVVVCVVG