VVVVVVVVVV
VVPPZPPPPV
VVPVRVCZVV
VBPVVVVPVB
VVPVPPPPPP
VVZVPRVVVV
VVPVPVCVVB
VVPVVZVPVV
ZVPBVVVVVV
VVPVVVVVVG