VPPPPPPPPP
VPVPRVVBVV
VPVPVVPPVZ
VPVPVVPPVV
VVBPVCPPVV
VPPPVVPPCV
ZPVVVZPPVV
VPVRVBVVVV
VPPZPPVVPV
VVVZVVVVPG

