VPVBVPZVVP
VPVPRPVPVP
VPVPVPVPZP
VPRPVPVPVP
VPBPCPVPVP
VPVPVPVPCP
ZPVPVPBPVP
VPVPBPZPVP
VPZPVPVPVP
VVVPVVVPVG

