VPVBVVVZVV
VPVPRVVBVV
VPVPVVPPVZ
VPVPVVPPVV
VVBPVCPPVV
VPPPVVPPCV
ZPVVVZPPVV
VPVRVBVVVV
VPPPPPVVPV
VVVZVVVVPG

