VVVBZVVVZV
PPPPPPPPPV
VRVVVZVVVR
VPPPPPPPPP
VCBVVVVVVV
PPPPPPPPPV
VVVVVCBVVV
VPVPBPZPVP
VVZVVVVVVV
PPPPPPPPPG

