VPVVBVVVPP
VVVPPZVVPP
VPPPRVVVBP      
VVVVVPPPVP
RPPPPPPPVP
VVBVVVZVVP
PVPVVVVVVZ
PZVVVVVCPP
PPPPPVVPPP
PCVVZVVVBG

