VVVVVVZVVV
VPPBPPPVPP
VPVRPVVZVB
VPVPPPPPPP
VZVVPVVVVB
VPVVPVRVVV
VPCVPVZVVC
VPVVPVVVVV
VBVVPVVVVV
VPVVZVVVVG