VVVVVVVVVR
PPPBPPPPVV
PPPPPPBPVV
ZVVVPVVPZV
VVVVPCVPVV
VZVVPVVVVB
VVVVVVCPPP
ZVPPPVZVVV
VVPBPVVVRV
VVVVPVVVVG